######
#    ##
# P  O #
#     #
# X   #
#     #
######
